111111
1000P1
100E01
100C01
100E01
111111