111111111111111111111111111
1CCCCCCCCCCCC1CCCCCCCCCCCC1
1C1111C11111CCC11111C1111C1
1C1111C11111C1C11111C1111C1
1CCCCCCCCCCCC1CCCCCCCCCCCC1
1C1111C1C111111111C1C1111C1
1CCCCCC1CCCCC1CCCCC1CCCCCC1
111C1CC11111C1C11111CC1C111
1CCC11CCCCCCCCCCCCCCC11CCC1
1C111CC1C111111111C1CC111C1
1CCCCC11C111111111C11CCCCC1
1C111CC1CCCCCPCCCCC1CC111C1
1CCC11C11111C1C11111C11CCC1
111C1CCCCCCCC1CCCCCCCC1C111
1CCC1C111111C1C111111C1CCC1
1C1CCCCCCCCCC1CCCCCCCCCC1C1
1CCC11C1C111111111C1C11CCC1
111C11C1CCCCC1CCCCC1C11C111
1CCCCCC11111C1C11111CCCCCC1
1C111C1C1CCCCCC1CCCC1C111C1
1CCCCCCCCC1EC1CCC11CCCCCCC1
111111111111111111111111111