11111111111111111111111
1001CCCCCCCCCCC1CCCCC11
1C0PCCCCCCCCCCC1CCCCC11
1C00CC11111CCCC1CCCCC11
1C01CCCCCCC1111CCCCCC11
1CE1CCCCCCCCCCCCCCCCC11
1001CCCCCCCCCCC1CCCCC11
1C00CCCCCCCCCCC1CCCCC11
1C00CC11111CCCC1CCCCC11
1C01CCCCCCC1111CCCCCC11
1CE1CCCCCCCCCCCCCCCCC11
1001CCCCCCCCCCC1CCCCC11
1C00CCCCCCCCCCC1CCCCC11
1C00CC11111CCCC1CCCCC11
1C01CCCCCCC1111CCCCCC11
1CE1CCCCCCCCCCCCCCCCC11
11111111111111111111111