1111111111111
10C0011000001
100E000C00111
10PC011110101
10000C0010011
1111111111111