11111111111111111111
1000R0000000000000E1
10000000000C00000001
100000G0000P00000001
11111111111111111111