1111111111111111111111111
1CCCCCCCRE1111CCCCCCCCCC1
1C111111111111C1C1C1C1C11
1CCCCCCCCCCCCCCCCCCCCCCC1
11C1C1C1C1C1C1C1C1C1C1C11
1CCCCCCCCCCCCCCCCCCCCCCC1
11C1C1C1C1C1C1C1C1C1C1C11
1CCCCCCCCCCCPCCCCCCCCCCC1
11C1C1C1C1C1C1C1C1C1C1C11
1CCCCCCCCCCCCCCCCCCCCCCC1
11C1C1C1C1C1C1C1C1C1C1C11
1CCCCCCCCCCCCCCCCCCCCCCC1
11C1C1C1C1C1C1C1111111111
1CCCCCCCCCCCCCCCCCCCCCGE1
1111111111111111111111111