11111111111111111111111
111111CCCCCCCCCCCCCCCC1
1PCCCCC11111111111111C1
1111111111CCCCCCCCCCCC1
1ECCCCCCCCC111111111111
11111111111111111111111