11111111111111111111
1000R0000000000000E1
1000000000C000000001
100000000G000P000001
11111111111111111111