11111111111111
10001100000001
111E0000011001
100000C000C001
11111111CCC001
11111111111111